111111111111111111111111111111111111
100000000000000000000000E00000000001
100000000000000000000000000000000001
10100001111111110000000000000C000001
10111110E00000000000000000000000P001
111111111111111111111111111111111111
