111111111111111111111111111111111111
1P00000000C0000000000000000000000001
1C0000000000000000000000000000000001
101000011111111100000000000000000001
1E1111100000000000000000000000000001
111111111111111111111111111111111111