111111111111111111111111111111111111
1000000000C0000000000000000000000001
1C00000000000000C00000C0000000C00001
101000011111111100000000000000000001
1C111110E00000000000000000000000P001
111111111111111111111111111111111111
