111111111111111111111111111111111111111111111111111111111111111111111
1P0C00000000000000000000000000000000000000000000000000000000000000001
100CCC000000000000000000000000000000000000000000000000000000000000001
10C0CCC00000000000000000000000000000000000000000000000000000000000001
10C0CCC00000000000000000000000000000000000000000000000000000000000001
10C0CCC00000000000000000000000000000000000000000000000000000000000001
10C0CCC00000000000000000000000000000000000000000000000000000000000001
10C0CCC00000000000000000000000000000000000000000000000000000000000001
10C0CCC00000000000000000000000000000000000000000000000000000000000001
10C0CCC00000000000000000000000000000000000000000000000000000000000001
10C0CCC00000000000000000000000000000000000000000000000000000000000001
10C0CCC00000000000000000000000000000000000000000000000000000000000002
10C0CCC00000000000000000000000000000000000000000000000000000000000001
10C0CCC00000000000000000000000000000000000000000000000000000000000001
10C0CCC00000000000000000000000000000000000000000000000000000000000001
10C0CCC00000000000000000000000000000000000000000000000000000000000001
10C0CCC00000000000000000000000000000000000000000000000000000000000001
10C0CCC00000000000000000000000000000000000000000000000000000000000001
10C0CCC00000000000000000000000000000000000000000000000000000000000001
10C0CCC00000000000000000000000000000000000000000000000000000000000001
10C0CCC00000000000000000000000000000000000000000000000000000000000001
10C0CCC00000000000000000000000000000000000000000000000000000000000001
10C0CCC00000000000000000000000000000000000000000000000000000000000001
10C0CCC00000000000000000000000000000000000000000000000000000000000001
10C0CCC00000000000000000000000000000000000000000000000000000000000001
10C0CCC00000000000000000000000000000000000000000000000000000000000001
10C0CCC00000000000000000000000000000000000000000000000000000000000001
10C0CCC00000000000000000000000000000000000000000000000000000000000001
10C0CCC00000000000000000000000000000000000000000000000000000000000001
10C0CCC00000000000000000000000000000000000000000000000000000000000001
10C0CCC00000000000000000000000000000000000000000000000000000000000001
10C0CCC00000000000000000000000000000000000000000000000000000000000001


